101~20~1~200000~00-00-0000
102~20~1~200000~00-00-0000
103~20~1~200000~00-00-0000
104~20~1~200000~00-00-0000
105~20~1~200000~00-00-0000
106~20~1~200000~00-00-0000
107~20~1~200000~00-00-0000
108~20~1~200000~00-00-0000
109~20~1~200000~00-00-0000
110~20~1~200000~00-00-0000
111~20~1~200000~00-00-0000
112~20~1~200000~00-00-0000
